####      ####
#  ########  #
# $ $ #    $ #
#   #   #    #
## ####### ###
#.*.*.. $    #
#+*...*   $  #
# ######## ###
# $ $ #      #
#   #   #  $ #
#  ########  #
####      ####
