#####  
#   ###
# #.. #
#     #
##$#$##
 # @ # 
 ##### 
